Sr.No,Class Name,Line Coverage,Branch Coverage,Branch Missed,Branch Missed+Covered,BranchCoveragePercentageDecimal,BranchCoveragePercentage
99,Abs,2,0,0,0,0,0
423,AbstractConvergenceChecker,8,0,0,0,0,0
656,AbstractConvergenceChecker,6,0,0,0,0,0
442,AbstractConvexHullGenerator2D,16,2,0,2,1,100
408,AbstractCurveFitter,3,0,0,0,0,0
643,AbstractDifferentiableOptimizer,0,0,0,0,0,0
664,AbstractDifferentiableUnivariateSolver,7,0,0,0,0,0
153,AbstractEvaluation,18,2,0,2,1,100
168,AbstractFieldIntegrator,123,44,6,50,0.88,88
306,AbstractFieldMatrix,375,203,39,242,0.838843,83.8843
612,AbstractFieldStepInterpolator,18,0,0,0,0,0
449,AbstractFormat,33,9,3,12,0.75,75
382,AbstractIntegerDistribution,56,35,9,44,0.79545456,79.545456
158,AbstractIntegrator,137,60,2,62,0.9677419,96.77419
528,AbstractLeastSquaresOptimizer,41,12,2,14,0.85714287,85.71429
640,AbstractLeastSquaresOptimizer,71,20,2,22,0.90909094,90.909096
24,AbstractLinearOptimizer,19,1,1,2,0.5,50
471,AbstractListChromosome,12,1,1,2,0.5,50
15,AbstractMultipleLinearRegression,78,42,6,48,0.875,87.5
368,AbstractMultivariateRealDistribution,12,3,1,4,0.75,75
657,AbstractOptimizationProblem,10,0,0,0,0,0
164,AbstractParameterizable,13,8,0,8,1,100
672,AbstractPolynomialSolver,6,0,0,0,0,0
553,AbstractRandomGenerator,40,17,5,22,0.77272725,77.27273
385,AbstractRealDistribution,62,39,5,44,0.8863636,88.63636
309,AbstractRealMatrix,338,176,22,198,0.8888889,88.88889
598,AbstractRegion,138,72,18,90,0.8,80
644,AbstractScalarDifferentiableOptimizer,7,0,0,0,0,0
336,AbstractSimplex,75,41,13,54,0.7592593,75.92593
638,AbstractSimplex,75,41,13,54,0.7592593,75.92593
608,AbstractStepInterpolator,171,25,9,34,0.7352941,73.52941
626,AbstractStorelessUnivariateStatistic,24,16,2,18,0.8888889,88.88889
604,AbstractSubHyperplane,40,14,2,16,0.875,87.5
670,AbstractUnivariateDifferentiableSolver,7,0,0,0,0,0
627,AbstractUnivariateStatistic,11,2,10,12,0.16666667,16.666668
568,AbstractWell,39,8,0,8,1,100
105,Acos,2,0,0,0,0,0
110,Acosh,0,0,0,0,0,0
269,AdamsBashforthFieldIntegrator,79,34,2,36,0.9444444,94.44444
270,AdamsBashforthIntegrator,83,35,3,38,0.92105263,92.10526
276,AdamsFieldIntegrator,10,0,0,0,0,0
263,AdamsFieldStepInterpolator,31,6,0,6,1,100
261,AdamsIntegrator,10,0,0,0,0,0
273,AdamsMoultonFieldIntegrator,70,29,1,30,0.96666664,96.666664
229,AdamsMoultonIntegrator,76,30,2,32,0.9375,93.75
271,AdamsNordsieckFieldTransformer,75,32,0,32,1,100
236,AdamsNordsieckTransformer,74,32,0,32,1,100
258,AdaptiveStepsizeFieldIntegrator,77,28,14,42,0.6666667,66.66667
246,AdaptiveStepsizeIntegrator,83,39,7,46,0.84782606,84.78261
102,Add,2,0,0,0,0,0
630,AggregateSummaryStatistics,56,15,9,24,0.625,62.5
485,AgrestiCoullInterval,11,0,0,0,0,0
186,AkimaSplineInterpolator,63,23,3,26,0.88461536,88.46153
439,AklToussaintHeuristic,44,41,3,44,0.9318182,93.181816
585,Arc,23,16,0,16,1,100
584,ArcsSet,215,111,15,126,0.88095236,88.09524
60,ArgUtils,8,7,1,8,0.875,87.5
50,ArithmeticUtils,200,140,10,150,0.93333334,93.333336
300,Array2DRowFieldMatrix,177,83,9,92,0.90217394,90.21739
286,Array2DRowRealMatrix,188,89,7,96,0.9270833,92.70833
316,ArrayFieldVector,289,96,18,114,0.84210527,84.210526
321,ArrayRealVector,357,140,4,144,0.9722222,97.22222
122,Asin,2,0,0,0,0,0
108,Asinh,0,0,0,0,0,0
91,Atan,2,0,0,0,0,0
94,Atan2,0,0,0,0,0,0
92,Atanh,0,0,0,0,0,0
506,AVLTree,38,27,9,36,0.75,75
340,BaseAbstractMultivariateOptimizer,62,33,5,38,0.8684211,86.84211
332,BaseAbstractMultivariateSimpleBoundsOptimizer,4,0,0,0,0,0
341,BaseAbstractMultivariateVectorOptimizer,42,11,11,22,0.5,50
211,BaseAbstractUnivariateIntegrator,40,3,1,4,0.75,75
5,BaseAbstractUnivariateOptimizer,27,2,2,4,0.5,50
675,BaseAbstractUnivariateSolver,43,0,0,0,0,0
661,BaseMultiStartMultivariateOptimizer,51,30,4,34,0.88235295,88.2353
422,BaseMultivariateMultiStartOptimizer,25,9,5,14,0.64285713,64.28571
649,BaseMultivariateOptimizer,36,28,2,30,0.93333334,93.333336
420,BaseMultivariateVectorMultiStartOptimizer,30,11,3,14,0.78571427,78.57143
650,BaseOptimizer,27,6,0,6,1,100
74,BaseRuleFactory,28,8,2,10,0.8,80
662,BaseSecantSolver,65,45,3,48,0.9375,93.75
352,BesselJ,242,113,19,132,0.8560606,85.606064
349,Beta,128,83,5,88,0.9431818,94.318184
354,BetaDistribution,42,11,9,20,0.55,55
198,BicubicInterpolatingFunction,63,42,6,48,0.875,87.5
191,BicubicInterpolator,28,9,3,12,0.75,75
181,BicubicSplineInterpolatingFunction,81,48,6,54,0.8888889,88.88889
196,BicubicSplineInterpolator,48,31,3,34,0.9117647,91.17647
289,BiDiagonalTransformer,155,103,7,110,0.93636364,93.63636
448,BigFraction,261,126,26,152,0.82894737,82.89474
445,BigFractionField,7,0,0,0,0,0
443,BigFractionFormat,54,19,2,21,0.9047619,90.47619
34,BigReal,76,4,0,4,1,100
54,BigRealField,6,0,0,0,0,0
462,BinaryChromosome,22,15,1,16,0.9375,93.75
461,BinaryMutation,8,3,1,4,0.75,75
372,BinomialDistribution,29,21,3,24,0.875,87.5
403,BinomialTest,30,19,7,26,0.7307692,73.07692
674,BisectionSolver,17,4,0,4,1,100
548,BitsStreamGenerator,51,15,13,28,0.53571427,53.571426
297,BlockFieldMatrix,634,230,34,264,0.8712121,87.121216
280,BlockRealMatrix,690,264,14,278,0.9496403,94.96403
337,BOBYQAOptimizer,1027,519,105,624,0.8317308,83.17308
637,BOBYQAOptimizer,1027,519,105,624,0.8317308,83.17308
606,BoundaryAttribute,8,0,0,0,0,0
601,BoundaryBuilder,27,14,0,14,1,100
595,BoundaryProjection,8,0,0,0,0,0
600,BoundaryProjector,51,26,4,30,0.8666667,86.666664
597,BoundarySizeVisitor,13,4,0,4,1,100
7,BracketFinder,76,30,16,46,0.65217394,65.21739
688,BracketFinder,83,36,10,46,0.7826087,78.26087
671,BracketingNthOrderBrentSolver,131,65,1,66,0.9848485,98.48485
140,BracketingNthOrderBrentSolverDFP,8,0,0,0,0,0
8,BrentOptimizer,116,69,5,74,0.9324324,93.24324
691,BrentOptimizer,115,69,5,74,0.9324324,93.24324
665,BrentSolver,83,39,1,40,0.975,97.5
596,BSPTree,208,85,14,99,0.85858583,85.85858
698,CanberraDistance,8,6,0,6,1,100
500,CardanEulerSingularityException,2,2,0,2,1,100
373,CauchyDistribution,30,10,0,10,1,100
135,Cbrt,2,0,0,0,0,0
101,Ceil,2,0,0,0,0,0
58,CentralPivotingStrategy,1,0,0,0,0,0
66,CentroidCluster,4,0,0,0,0,0
599,Characterization,42,18,2,20,0.9,90
694,ChebyshevDistance,2,0,0,0,0,0
361,ChiSquaredDistribution,22,0,0,0,0,0
397,ChiSquareTest,101,56,8,64,0.875,87.5
294,CholeskyDecomposition,45,22,0,22,1,100
463,Chromosome,15,7,1,8,0.875,87.5
457,ChromosomePair,6,0,0,0,0,0
535,Circle,43,2,0,2,1,100
254,ClassicalRungeKuttaFieldIntegrator,24,2,0,2,1,100
252,ClassicalRungeKuttaFieldStepInterpolator,26,3,1,4,0.75,75
240,ClassicalRungeKuttaStepInterpolator,35,7,1,8,0.875,87.5
482,ClopperPearsonInterval,14,2,2,4,0.5,50
69,Cluster,6,0,0,0,0,0
392,Cluster,8,0,0,0,0,0
67,Clusterer,5,0,0,0,0,0
206,ClusterEvaluator,19,11,1,12,0.9166667,91.66667
333,CMAESOptimizer,377,177,39,216,0.8194444,81.94444
639,CMAESOptimizer,377,182,36,218,0.8348624,83.486244
40,Combinations,15,5,1,6,0.8333333,83.33333
42,CombinatoricsUtils,120,96,2,98,0.97959185,97.95918
540,Complex,223,168,14,182,0.9230769,92.30769
541,ComplexField,6,0,0,0,0,0
544,ComplexFormat,76,21,17,38,0.55263156,55.263157
543,ComplexUtils,8,4,0,4,1,100
45,CompositeFormat,56,27,1,28,0.96428573,96.42857
484,ConfidenceInterval,12,3,3,6,0.5,50
318,ConjugateGradient,61,15,3,18,0.8333333,83.33333
100,Constant,5,0,0,0,0,0
389,ConstantRealDistribution,16,8,0,8,1,100
48,ContinuedFraction,31,9,7,16,0.5625,56.25
173,ContinuousOutputFieldModel,112,46,4,50,0.92,92
160,ContinuousOutputModel,110,45,3,48,0.9375,93.75
522,ConvergenceException,5,0,0,0,0,0
441,ConvexHull2D,53,28,2,30,0.93333334,93.333336
563,CorrelatedRandomVectorGenerator,19,7,3,10,0.7,70
129,Cos,3,0,0,0,0,0
93,Cosh,3,0,0,0,0,0
328,Covariance,48,12,4,16,0.75,75
217,CurveFitter,22,3,1,4,0.75,75
414,CurveFitter,26,2,0,2,1,100
467,CycleCrossover,42,21,1,22,0.95454544,95.454544
68,DBSCANClusterer,55,28,0,28,1,100
394,DBSCANClusterer,53,28,0,28,1,100
31,Decimal64,86,12,2,14,0.85714287,85.71429
35,Decimal64Field,7,0,0,0,0,0
293,DefaultFieldMatrixChangingVisitor,5,0,0,0,0,0
283,DefaultFieldMatrixPreservingVisitor,5,0,0,0,0,0
279,DefaultIterativeLinearSolverEvent,17,1,3,4,0.25,25
322,DefaultMeasurementModel,6,0,0,0,0,0
324,DefaultProcessModel,12,0,0,0,0,0
290,DefaultRealMatrixChangingVisitor,3,0,0,0,0,0
305,DefaultRealMatrixPreservingVisitor,3,0,0,0,0,0
30,DefaultTransformer,12,6,0,6,1,100
149,DenseWeightedEvaluation,7,0,0,0,0,0
574,DerivativeStructure,304,68,2,70,0.9714286,97.14286
625,DescriptiveStatistics,145,21,3,24,0.875,87.5
137,Dfp,1016,699,81,780,0.89615387,89.61539
138,DfpDec,109,100,12,112,0.89285713,89.28571
136,DfpField,156,39,7,46,0.84782606,84.78261
139,DfpMath,337,154,40,194,0.7938144,79.38144
291,DiagonalMatrix,84,37,1,38,0.9736842,97.368416
509,DimensionMismatchException,6,0,0,0,0,0
617,DiskGenerator,33,6,0,6,1,100
95,Divide,2,0,0,0,0,0
187,DividedDifferenceInterpolator,17,4,0,4,1,100
267,DormandPrince54FieldIntegrator,75,6,0,6,1,100
266,DormandPrince54FieldStepInterpolator,124,3,1,4,0.75,75
259,DormandPrince54Integrator,16,4,0,4,1,100
274,DormandPrince54StepInterpolator,62,15,1,16,0.9375,93.75
257,DormandPrince853FieldIntegrator,229,7,1,8,0.875,87.5
260,DormandPrince853FieldStepInterpolator,182,7,1,8,0.875,87.5
250,DormandPrince853Integrator,43,6,0,6,1,100
235,DormandPrince853StepInterpolator,116,43,5,48,0.8958333,89.58333
65,DoublePoint,12,3,1,4,0.75,75
576,DSCompiler,570,294,2,296,0.9932432,99.324326
59,DummyLocalizable,0,0,0,0,0,0
607,DummyStepHandler,0,0,0,0,0,0
695,EarthMoversDistance,9,2,0,2,1,100
532,Edge,47,11,1,12,0.9166667,91.66667
536,EdgesBuilder,52,23,1,24,0.9583333,95.83333
296,EigenDecomposition,281,146,18,164,0.8902439,89.02439
465,ElitisticListPopulation,20,6,0,6,1,100
232,EmbeddedRungeKuttaFieldIntegrator,101,50,0,50,1,100
247,EmbeddedRungeKuttaIntegrator,112,54,0,54,1,100
572,EmpiricalDistribution,148,46,6,52,0.88461536,88.46153
646,EnclosingBall,11,4,0,4,1,100
360,EnumeratedDistribution,45,25,17,42,0.5952381,59.523808
369,EnumeratedIntegerDistribution,66,30,0,30,1,100
388,EnumeratedRealDistribution,81,37,3,40,0.925,92.5
171,EquationsMapper,12,2,2,4,0.5,50
351,Erf,84,28,0,28,1,100
19,Euclidean1D,6,0,0,0,0,0
618,Euclidean2D,6,0,0,0,0,0
498,Euclidean3D,6,0,0,0,0,0
696,EuclideanDistance,2,0,0,0,0,0
390,EuclideanDoublePoint,16,7,1,8,0.875,87.5
391,EuclideanIntegerPoint,16,7,1,8,0.875,87.5
245,EulerFieldIntegrator,8,0,0,0,0,0
241,EulerFieldStepInterpolator,9,3,1,4,0.75,75
275,EulerStepInterpolator,13,7,1,8,0.875,87.5
146,EvaluationRmsChecker,8,4,0,4,1,100
702,EventFilter,42,20,2,22,0.90909094,90.909096
703,EventState,106,64,10,74,0.8648649,86.48649
62,ExceptionContext,79,20,0,20,1,100
128,Exp,2,0,0,0,0,0
155,ExpandableStatefulODE,58,14,4,18,0.7777778,77.77778
98,Expm1,2,0,0,0,0,0
3,ExponentialDecayFunction,13,8,0,8,1,100
365,ExponentialDistribution,61,24,0,24,1,100
176,FastCosineTransformer,44,14,0,14,1,100
174,FastFourierTransformer,169,54,9,63,0.85714287,85.71429
177,FastHadamardTransformer,39,17,1,18,0.9444444,94.44444
33,FastMath,1434,775,53,828,0.93599033,93.59903
43,FastMathCalc,0,0,62,62,0,0
46,FastMathLiteralArrays,10,0,0,0,0,0
178,FastSineTransformer,40,14,0,14,1,100
358,FDistribution,56,12,0,12,1,100
479,FeatureInitializerFactory,4,0,0,0,0,0
663,FieldBracketingNthOrderBrentSolver,121,61,5,66,0.92424244,92.42424
162,FieldEquationsMapper,61,26,0,26,1,100
699,FieldEventState,72,37,27,64,0.578125,57.8125
170,FieldExpandableODE,28,4,0,4,1,100
183,FieldHermiteInterpolator,64,30,0,30,1,100
317,FieldLUDecomposition,82,52,2,54,0.962963,96.296295
166,FieldODEState,19,10,0,10,1,100
169,FieldODEStateAndDerivative,8,2,0,2,1,100
487,FieldRotation,548,191,3,194,0.9845361,98.45361
613,FieldStepNormalizer,0,0,32,32,0,0
502,FieldVector3D,259,72,0,72,1,100
701,FilterType,3,0,0,0,0,0
575,FiniteDifferencesDifferentiator,42,14,0,14,1,100
83,FirstMoment,32,2,0,2,1,100
161,FirstOrderConverter,14,0,0,0,0,0
458,FixedElapsedTime,8,5,1,6,0.8333333,83.33333
470,FixedGenerationCount,9,3,1,4,0.75,75
97,Floor,2,0,0,0,0,0
79,FourthMoment,26,2,0,2,1,100
451,Fraction,179,90,8,98,0.9183673,91.83673
444,FractionField,7,0,0,0,0,0
446,FractionFormat,43,12,1,13,0.9230769,92.30769
474,Frequency,143,47,9,56,0.83928573,83.92857
573,FunctionUtils,27,6,0,6,1,100
63,FuzzyKMeansClusterer,104,42,14,56,0.75,75
350,Gamma,164,92,6,98,0.93877554,93.877556
355,GammaDistribution,80,28,4,32,0.875,87.5
111,Gaussian,37,14,0,14,1,100
409,GaussianCurveFitter,28,4,0,4,1,100
218,GaussianFitter,6,0,0,0,0,0
407,GaussianFitter,6,0,0,0,0,0
558,GaussianRandomGenerator,4,0,0,0,0,0
77,GaussIntegrator,21,3,1,4,0.75,75
75,GaussIntegratorFactory,18,2,0,2,1,100
152,GaussNewtonOptimizer,41,17,1,18,0.9444444,94.44444
529,GaussNewtonOptimizer,59,23,3,26,0.88461536,88.46153
645,GaussNewtonOptimizer,56,19,3,22,0.8636364,86.36364
472,GeneticAlgorithm,39,12,6,18,0.6666667,66.66667
371,GeometricDistribution,28,16,2,18,0.8888889,88.88889
85,GeometricMean,29,3,1,4,0.75,75
231,GillFieldIntegrator,28,2,0,2,1,100
238,GillFieldStepInterpolator,33,3,1,4,0.75,75
277,GillStepInterpolator,43,7,1,8,0.875,87.5
11,GLSMultipleLinearRegression,21,2,0,2,1,100
578,GradientFunction,14,4,0,4,1,100
591,GradientMultivariateOptimizer,10,3,1,4,0.75,75
265,GraggBulirschStoerIntegrator,305,212,22,234,0.9059829,90.59829
255,GraggBulirschStoerStepInterpolator,127,43,15,58,0.7413793,74.13793
398,GTest,85,50,6,56,0.89285713,89.28571
376,GumbelDistribution,24,7,3,10,0.7,70
565,HaltonSequenceGenerator,33,16,0,16,1,100
413,HarmonicCurveFitter,27,4,0,4,1,100
219,HarmonicFitter,4,0,0,0,0,0
411,HarmonicFitter,4,0,0,0,0,0
109,HarmonicOscillator,17,4,0,4,1,100
189,HermiteInterpolator,62,28,0,28,1,100
73,HermiteRuleFactory,69,24,0,24,1,100
301,HessenbergTransformer,76,51,3,54,0.9444444,94.44444
230,HighamHall54FieldIntegrator,76,8,0,8,1,100
248,HighamHall54FieldStepInterpolator,30,3,1,4,0.75,75
234,HighamHall54Integrator,19,6,0,6,1,100
256,HighamHall54StepInterpolator,41,7,1,8,0.875,87.5
344,HitHistogram,0,0,8,8,0,0
366,HypergeometricDistribution,74,27,1,28,0.96428573,96.42857
116,Identity,3,0,0,0,0,0
49,Incrementor,23,7,1,8,0.875,87.5
425,InitialGuess,4,0,0,0,0,0
659,InitialGuess,4,0,0,0,0,0
602,InsideFinder,0,0,50,50,0,0
52,IntegerSequence,2,0,0,0,0,0
202,InterpolatingMicrosphere,58,31,11,42,0.7380952,73.809525
184,InterpolatingMicrosphere2D,6,2,0,2,1,100
22,Interval,16,10,0,10,1,100
20,IntervalsSet,125,77,15,92,0.8369565,83.69565
481,IntervalUtils,19,10,0,10,1,100
134,Inverse,3,0,0,0,0,0
551,ISAACRandom,124,19,1,20,0.95,95
39,IterationEvent,4,0,0,0,0,0
53,IterationManager,27,8,0,8,1,100
209,IterativeLegendreGaussIntegrator,34,7,1,8,0.875,87.5
320,IterativeLinearSolver,17,6,0,6,1,100
313,IterativeLinearSolverEvent,2,0,0,0,0,0
579,JacobianFunction,15,6,0,6,1,100
156,JacobianMatrices,68,25,9,34,0.7352941,73.52941
682,JacobianMultivariateVectorOptimizer,10,4,0,4,1,100
304,JacobiPreconditioner,23,7,1,8,0.875,87.5
571,JDKRandomGenerator,7,0,0,0,0,0
323,KalmanFilter,71,22,8,30,0.73333335,73.333336
329,KendallsCorrelation,85,31,1,32,0.96875,96.875
70,KMeansPlusPlusClusterer,104,50,38,88,0.5681818,56.81818
393,KMeansPlusPlusClusterer,158,78,14,92,0.84782606,84.78261
455,KohonenTrainingTask,8,2,0,2,1,100
453,KohonenUpdateAction,38,9,1,10,0.9,90
374,KolmogorovSmirnovDistribution,59,36,12,48,0.75,75
401,KolmogorovSmirnovTest,304,146,62,208,0.7019231,70.19231
41,KthSelector,47,37,1,38,0.9736842,97.368416
78,Kurtosis,49,13,3,16,0.8125,81.25
676,LaguerreSolver,29,8,8,16,0.5,50
384,LaplaceDistribution,24,11,3,14,0.78571427,78.57143
452,LearningFactorFunctionFactory,6,8,0,8,1,100
148,LeastSquaresAdapter,10,0,0,0,0,0
151,LeastSquaresBuilder,22,0,0,0,0,0
419,LeastSquaresConverter,35,15,3,18,0.8333333,83.33333
593,LeastSquaresConverter,35,15,3,18,0.8333333,83.33333
154,LeastSquaresFactory,16,6,0,6,1,100
207,LegendreGaussIntegrator,68,12,1,13,0.9230769,92.30769
71,LegendreHighPrecisionRuleFactory,98,24,0,24,1,100
76,LegendreRuleFactory,61,24,0,24,1,100
150,LevenbergMarquardtOptimizer,361,186,16,202,0.9207921,92.07921
527,LevenbergMarquardtOptimizer,363,187,19,206,0.907767,90.7767
641,LevenbergMarquardtOptimizer,360,181,21,202,0.8960396,89.60396
383,LevyDistribution,26,7,3,10,0.7,70
582,LimitAngle,15,5,1,6,0.8333333,83.33333
490,Line,46,12,4,16,0.75,75
615,Line,81,15,5,20,0.75,75
25,LinearConstraint,21,5,7,12,0.41666666,41.666664
220,LinearConstraint,24,6,6,12,0.5,50
226,LinearConstraintSet,5,0,2,2,0,0
199,LinearInterpolator,18,8,0,8,1,100
27,LinearObjectiveFunction,19,4,4,8,0.5,50
223,LinearObjectiveFunction,20,4,4,8,0.5,50
225,LinearOptimizer,18,8,0,8,1,100
589,LineSearch,14,0,0,0,0,0
468,ListPopulation,41,17,5,22,0.77272725,77.27273
61,LocalizedFormats,340,1,1,2,0.5,50
343,LocationFinder,11,5,1,6,0.8333333,83.33333
180,LoessInterpolator,110,48,4,52,0.9230769,92.30769
130,Log,3,0,0,0,0,0
121,Log10,2,0,0,0,0,0
126,Log1p,2,0,0,0,0,0
104,Logistic,13,2,0,2,1,100
359,LogisticDistribution,24,7,3,10,0.7,70
103,Logit,27,16,0,16,1,100
381,LogNormalDistribution,58,16,2,18,0.8888889,88.88889
285,LUDecomposition,85,54,0,54,1,100
251,LutherFieldIntegrator,47,2,0,2,1,100
262,LutherFieldStepInterpolator,48,3,1,4,0.75,75
249,LutherStepInterpolator,50,7,1,8,0.875,87.5
697,ManhattanDistance,2,0,0,0,0,0
399,MannWhitneyUTest,31,10,0,10,1,100
478,MapUtils,20,8,32,40,0.2,20
513,MathArithmeticException,10,0,0,0,0,0
44,MathArrays,465,245,46,291,0.84192437,84.19244
519,MathIllegalArgumentException,6,0,0,0,0,0
526,MathIllegalNumberException,5,0,0,0,0,0
524,MathIllegalStateException,8,0,0,0,0,0
523,MathInternalError,0,0,0,0,0,0
514,MathParseException,4,0,0,0,0,0
512,MathUnsupportedOperationException,6,0,0,0,0,0
37,MathUtils,38,44,22,66,0.6666667,66.66667
310,MatrixDimensionMismatchException,8,0,0,0,0,0
314,MatrixUtils,229,116,42,158,0.73417723,73.417725
106,Max,2,0,0,0,0,0
145,Max,29,12,0,12,1,100
510,MaxCountExceededException,7,0,0,0,0,0
653,MaxEval,5,1,1,2,0.5,50
648,MaxIter,5,1,1,2,0.5,50
87,Mean,43,9,3,12,0.75,75
143,Median,6,0,0,0,0,0
36,MedianOf3PivotingStrategy,14,10,0,10,1,100
562,MersenneTwister,74,27,1,28,0.96428573,96.42857
192,MicrosphereInterpolatingFunction,42,22,8,30,0.73333335,73.333336
194,MicrosphereInterpolator,10,2,2,4,0.5,50
193,MicrosphereProjectionInterpolator,17,8,8,16,0.5,50
272,MidpointFieldIntegrator,13,0,0,0,0,0
239,MidpointFieldStepInterpolator,16,3,1,4,0.75,75
213,MidPointIntegrator,32,9,3,12,0.75,75
268,MidpointStepInterpolator,24,7,1,8,0.875,87.5
13,MillerUpdatingRegression,429,208,66,274,0.7591241,75.91241
113,Min,2,0,0,0,0,0
144,Min,29,12,0,12,1,100
119,Minus,3,0,0,0,0,0
375,MixtureMultivariateNormalDistribution,9,2,0,2,1,100
353,MixtureMultivariateRealDistribution,43,19,3,22,0.8636364,86.36364
683,ModelFunction,4,0,0,0,0,0
684,ModelFunctionJacobian,4,0,0,0,0,0
440,MonotoneChain,50,28,4,32,0.875,87.5
678,MullerSolver,59,31,5,36,0.8611111,86.11111
668,MullerSolver2,49,15,5,20,0.75,75
47,MultidimensionalCounter,45,22,2,24,0.9166667,91.66667
518,MultiDimensionMismatchException,6,0,0,0,0,0
338,MultiDirectionalSimplex,42,8,0,8,1,100
635,MultiDirectionalSimplex,42,8,0,8,1,100
64,MultiKMeansPlusPlusClusterer,16,4,0,4,1,100
118,Multiply,2,0,0,0,0,0
592,MultiStartMultivariateOptimizer,11,0,0,0,0,0
685,MultiStartMultivariateVectorOptimizer,11,0,0,0,0,0
690,MultiStartUnivariateOptimizer,49,18,2,20,0.9,90
159,MultistepFieldIntegrator,49,7,1,8,0.875,87.5
167,MultistepIntegrator,37,2,2,4,0.5,50
342,MultivariateFunctionMappingAdapter,26,16,2,18,0.8888889,88.88889
588,MultivariateFunctionMappingAdapter,26,16,2,18,0.8888889,88.88889
339,MultivariateFunctionPenaltyAdapter,26,17,3,20,0.85,85
590,MultivariateFunctionPenaltyAdapter,26,17,3,20,0.85,85
386,MultivariateNormalDistribution,49,22,6,28,0.78571427,78.57143
530,MultivariateNormalMixtureExpectationMaximization,108,51,3,54,0.9444444,94.44444
586,MultivariateOptimizer,15,6,0,6,1,100
623,MultivariateSummaryStatistics,145,36,8,44,0.8181818,81.818184
680,MultivariateVectorOptimizer,25,10,0,10,1,100
364,NakagamiDistribution,27,4,2,6,0.6666667,66.66667
428,NaturalRanking,118,54,2,56,0.96428573,96.42857
454,NeighbourhoodSizeFunctionFactory,2,0,0,0,0,0
334,NelderMeadSimplex,82,31,1,32,0.96875,96.875
634,NelderMeadSimplex,82,31,1,32,0.96875,96.875
622,NestedLoops,0,0,28,28,0,0
477,Network,106,39,9,48,0.8125,81.25
476,Neuron,33,10,2,12,0.8333333,83.33333
433,NeuronSquareMesh2D,152,139,10,149,0.9328859,93.28859
204,NeuronString,40,18,4,22,0.8181818,81.818184
197,NevilleInterpolator,2,0,0,0,0,0
666,NewtonRaphsonSolver,14,2,0,2,1,100
677,NewtonSolver,12,2,0,2,1,100
511,NoBracketingException,8,0,0,0,0,0
603,NodesSet,14,6,0,6,1,100
1,NonLinearConjugateGradientOptimizer,61,28,5,33,0.8484849,84.84849
642,NonLinearConjugateGradientOptimizer,65,27,7,34,0.7941176,79.411766
520,NonMonotonicSequenceException,13,6,0,6,1,100
221,NonNegativeConstraint,4,0,0,0,0,0
303,NonPositiveDefiniteMatrixException,7,0,0,0,0,0
288,NonSymmetricMatrixException,5,0,0,0,0,0
611,NordsieckStepInterpolator,80,27,11,38,0.7105263,71.05263
480,NormalApproximationInterval,8,0,0,0,0,0
378,NormalDistribution,46,12,0,12,1,100
469,NPointCrossover,35,15,1,16,0.9375,93.75
517,NumberIsTooLargeException,8,2,0,2,1,100
525,NumberIsTooSmallException,8,2,0,2,1,100
594,ObjectiveFunction,4,0,0,0,0,0
587,ObjectiveFunctionGradient,4,0,0,0,0,0
12,OLSMultipleLinearRegression,43,12,0,12,1,100
466,OnePointCrossover,18,7,3,10,0.7,70
400,OneWayAnova,55,18,2,20,0.9,90
29,OpenIntToDoubleHashMap,157,68,0,68,1,100
55,OpenIntToFieldHashMap,155,68,0,68,1,100
299,OpenMapRealMatrix,82,20,4,24,0.8333333,83.33333
298,OpenMapRealVector,269,117,7,124,0.9435484,94.354836
147,OptimumImpl,12,0,0,0,0,0
456,OrderedCrossover,37,14,0,14,1,100
507,OrderedTuple,0,0,94,94,0,0
16,OrientedPoint,12,4,2,6,0.6666667,66.66667
488,OutlineExtractor,0,0,14,14,0,0
508,OutOfRangeException,8,0,0,0,0,0
57,Pair,21,15,5,20,0.75,75
163,ParameterConfiguration,8,0,0,0,0,0
165,ParameterizedWrapper,0,0,2,2,0,0
172,ParameterJacobianWrapper,22,6,2,8,0.75,75
380,ParetoDistribution,39,13,1,14,0.9285714,92.85714
370,PascalDistribution,34,9,3,12,0.75,75
326,PearsonsCorrelation,75,27,3,30,0.9,90
141,Percentile,106,42,3,45,0.93333334,93.333336
200,PiecewiseBicubicSplineInterpolatingFunction,48,36,16,52,0.6923077,69.230774
185,PiecewiseBicubicSplineInterpolator,7,10,4,14,0.71428573,71.42857
499,Plane,93,19,3,22,0.8636364,86.36364
416,PointValuePair,10,4,2,6,0.6666667,66.66667
654,PointValuePair,10,4,2,6,0.6666667,66.66667
427,PointVectorValuePair,13,9,3,12,0.75,75
651,PointVectorValuePair,13,9,3,12,0.75,75
379,PoissonDistribution,99,40,4,44,0.90909094,90.909096
505,PollardRho,0,0,22,22,0,0
619,PolygonsSet,217,135,38,173,0.7803468,78.03468
495,PolyhedronsSet,130,78,16,94,0.82978725,82.97873
404,PolynomialCurveFitter,26,3,1,4,0.75,75
215,PolynomialFitter,4,0,0,0,0,0
410,PolynomialFitter,3,0,0,0,0,0
438,PolynomialFunction,84,47,15,62,0.7580645,75.80645
435,PolynomialFunctionLagrangeForm,73,31,3,34,0.9117647,91.17647
434,PolynomialFunctionNewtonForm,44,15,3,18,0.8333333,83.33333
436,PolynomialSplineFunction,37,19,11,30,0.6333333,63.333332
437,PolynomialsUtils,72,20,0,20,1,100
133,Pow,2,0,0,0,0,0
335,PowellOptimizer,85,29,3,32,0.90625,90.625
636,PowellOptimizer,89,32,4,36,0.8888889,88.88889
115,Power,5,0,0,0,0,0
38,Precision,116,98,33,131,0.7480916,74.80916
307,PreconditionedIterativeLinearSolver,21,6,0,6,1,100
504,Primes,29,26,0,26,1,100
430,Product,34,6,2,8,0.75,75
447,ProperBigFractionFormat,58,23,4,27,0.8518519,85.18519
450,ProperFractionFormat,54,15,4,19,0.7894737,78.94737
537,PropertiesComputer,41,13,3,16,0.8125,81.25
142,PSquarePercentile,77,48,0,48,1,100
315,QRDecomposition,77,42,0,42,1,100
347,QuantizationError,0,0,8,8,0,0
2,QuasiSigmoidDecayFunction,18,6,0,6,1,100
542,Quaternion,97,26,6,32,0.8125,81.25
564,RandomAdaptor,16,2,4,6,0.33333334,33.333336
552,RandomDataGenerator,137,53,17,70,0.75714284,75.71429
567,RandomDataImpl,5,0,0,0,0,0
569,RandomGeneratorFactory,1,0,2,2,0,0
459,RandomKey,63,29,3,32,0.90625,90.625
464,RandomKeyMutation,8,1,1,2,0.5,50
51,RandomPivotingStrategy,3,0,0,0,0,0
278,RealLinearOperator,1,0,0,0,0,0
311,RealMatrixFormat,95,41,3,44,0.9318182,93.181816
312,RealVector,210,82,0,82,1,100
302,RealVectorFormat,58,22,0,22,1,100
284,RectangularCholeskyDecomposition,54,26,2,28,0.9285714,92.85714
605,RegionFactory,66,32,3,35,0.9142857,91.42857
10,RegressionResults,53,30,28,58,0.51724136,51.724136
23,Relationship,11,3,0,3,1,100
222,Relationship,11,3,0,3,1,100
32,ResizableDoubleArray,216,78,11,89,0.8764045,87.64045
669,RiddersSolver,46,12,4,16,0.75,75
107,Rint,2,0,0,0,0,0
210,RombergIntegrator,31,8,4,12,0.6666667,66.66667
545,RootsOfUnity,40,19,5,24,0.7916667,79.16667
492,Rotation,486,187,3,190,0.98421055,98.42106
486,RotationOrder,22,0,0,0,0,0
282,RRQRDecomposition,47,18,2,20,0.9,90
237,RungeKuttaFieldIntegrator,73,39,1,40,0.975,97.5
264,RungeKuttaFieldStepInterpolator,14,6,0,6,1,100
243,RungeKuttaIntegrator,82,43,1,44,0.97727275,97.72727
233,RungeKuttaStepInterpolator,49,23,7,30,0.76666665,76.666664
581,S1Point,24,8,2,10,0.8,80
534,S2Point,42,16,4,20,0.8,80
362,SaddlePointExpansion,41,15,1,16,0.9375,93.75
308,SchurTransformer,189,83,7,90,0.9222222,92.22222
687,SearchInterval,12,3,3,6,0.5,50
667,SecantSolver,26,9,1,10,0.9,90
84,SecondMoment,20,2,0,2,1,100
493,Segment,8,0,0,0,0,0
621,Segment,16,2,2,4,0.5,50
88,SemiVariance,32,12,0,12,1,100
114,Sigmoid,28,8,0,8,1,100
117,Signum,2,0,0,0,0,0
426,SimpleBounds,6,0,0,0,0,0
660,SimpleBounds,11,0,0,0,0,0
406,SimpleCurveFitter,24,2,0,2,1,100
418,SimplePointChecker,21,10,2,12,0.8333333,83.33333
658,SimplePointChecker,21,10,2,12,0.8333333,83.33333
14,SimpleRegression,179,80,44,124,0.6451613,64.51613
4,SimpleUnivariateValueChecker,16,8,2,10,0.8,80
693,SimpleUnivariateValueChecker,16,9,1,10,0.9,90
417,SimpleValueChecker,16,9,1,10,0.9,90
655,SimpleValueChecker,16,9,1,10,0.9,90
421,SimpleVectorValueChecker,21,12,0,12,1,100
652,SimpleVectorValueChecker,21,12,0,12,1,100
331,SimplexOptimizer,33,17,1,18,0.9444444,94.44444
633,SimplexOptimizer,36,19,3,22,0.8636364,86.36364
26,SimplexSolver,82,54,0,54,1,100
224,SimplexSolver,101,61,3,64,0.953125,95.3125
28,SimplexTableau,178,117,11,128,0.9140625,91.40625
227,SimplexTableau,205,127,11,138,0.9202899,92.028984
208,SimpsonIntegrator,22,7,5,12,0.5833333,58.333332
120,Sin,4,0,0,0,0,0
131,Sinc,50,24,2,26,0.9230769,92.30769
292,SingularValueDecomposition,271,171,13,184,0.9293478,92.934784
132,Sinh,2,0,0,0,0,0
89,Skewness,52,14,2,16,0.875,87.5
503,SmallPrimes,53,30,4,34,0.88235295,88.2353
345,SmoothedDataHistogram,0,0,8,8,0,0
182,SmoothingPolynomialBicubicSplineInterpolator,45,27,5,32,0.84375,84.375
546,SobolSequenceGenerator,86,36,6,42,0.85714287,85.71429
228,SolutionCallback,5,4,0,4,1,100
295,SparseFieldMatrix,24,2,8,10,0.2,20
287,SparseFieldVector,207,76,36,112,0.6785714,67.85714
577,SparseGradient,247,106,6,112,0.9464286,94.64286
327,SpearmansCorrelation,59,27,5,32,0.84375,84.375
583,Sphere1D,6,0,0,0,0,0
533,Sphere2D,5,0,0,0,0,0
494,SphereGenerator,62,8,0,8,1,100
501,SphericalCoordinates,117,2,2,4,0.5,50
539,SphericalPolygonsSet,146,69,13,82,0.8414634,84.14634
188,SplineInterpolator,38,12,0,12,1,100
123,Sqrt,3,0,0,0,0,0
555,StableRandomGenerator,31,19,5,24,0.7916667,79.16667
80,StandardDeviation,28,0,0,0,0,0
631,StatisticalSummaryValues,45,11,5,16,0.6875,68.75
475,StatUtils,80,23,7,30,0.76666665,76.666664
112,StepFunction,19,14,0,14,1,100
609,StepNormalizer,59,33,1,34,0.9705882,97.05882
610,StepNormalizerBounds,11,0,0,0,0,0
330,StorelessBivariateCovariance,26,2,2,4,0.5,50
325,StorelessCovariance,27,15,7,22,0.6818182,68.181816
531,SubCircle,14,8,0,8,1,100
580,SubLimitAngle,7,2,0,2,1,100
491,SubLine,28,14,0,14,1,100
614,SubLine,54,28,0,28,1,100
21,SubOrientedPoint,10,4,0,4,1,100
496,SubPlane,32,11,1,12,0.9166667,91.66667
127,Subtract,0,0,0,0,0,0
432,Sum,33,6,2,8,0.75,75
629,SummaryStatistics,169,41,19,60,0.68333334,68.333336
205,SumOfClusterVariances,13,5,1,6,0.8333333,83.33333
431,SumOfLogs,27,3,1,4,0.75,75
429,SumOfSquares,27,3,1,4,0.75,75
72,SymmetricGaussIntegrator,25,6,0,6,1,100
281,SymmLQ,48,8,2,10,0.8,80
624,SynchronizedDescriptiveStatistics,28,0,0,0,0,0
632,SynchronizedMultivariateSummaryStatistics,41,0,0,0,0,0
554,SynchronizedRandomGenerator,12,0,0,0,0,0
628,SynchronizedSummaryStatistics,30,0,0,0,0,0
96,Tan,2,0,0,0,0,0
125,Tanh,2,0,0,0,0,0
415,Target,4,0,0,0,0,0
681,Target,4,0,0,0,0,0
367,TDistribution,47,13,1,14,0.9285714,92.85714
395,TestUtils,44,0,0,0,0,0
82,ThirdMoment,29,2,0,2,1,100
253,ThreeEighthesFieldIntegrator,24,2,0,2,1,100
242,ThreeEighthesFieldStepInterpolator,27,3,1,4,0.75,75
244,ThreeEighthesStepInterpolator,38,7,1,8,0.875,87.5
516,TooManyEvaluationsException,3,0,0,0,0,0
521,TooManyIterationsException,3,0,0,0,0,0
348,TopographicErrorHistogram,0,0,10,10,0,0
460,TournamentSelection,13,3,1,4,0.75,75
700,Transformer,6,0,0,0,0,0
56,TransformerMap,31,12,8,20,0.6,60.000004
175,TransformUtils,24,10,4,14,0.71428573,71.42857
212,TrapezoidIntegrator,37,10,4,14,0.71428573,71.42857
357,TriangularDistribution,58,36,4,40,0.9,90
195,TricubicInterpolatingFunction,104,70,22,92,0.76086956,76.08696
201,TricubicInterpolator,51,16,4,20,0.8,80
179,TricubicSplineInterpolatingFunction,97,70,10,80,0.875,87.5
190,TricubicSplineInterpolator,78,50,4,54,0.9259259,92.59259
319,TriDiagonalTransformer,88,46,0,46,1,100
402,TTest,98,23,1,24,0.9583333,95.83333
124,Ulp,2,0,0,0,0,0
547,UncorrelatedRandomVectorGenerator,16,3,1,4,0.75,75
346,UnifiedDistanceMatrix,0,0,28,28,0,0
473,UniformCrossover,24,14,0,14,1,100
377,UniformIntegerDistribution,29,16,0,16,1,100
550,UniformRandomGenerator,5,0,0,0,0,0
363,UniformRealDistribution,31,14,0,14,1,100
559,UnitSphereRandomVectorGenerator,16,4,0,4,1,100
9,UnivariateMultiStartOptimizer,28,10,4,14,0.71428573,71.42857
692,UnivariateObjectiveFunction,4,0,0,0,0,0
689,UnivariateOptimizer,24,8,0,8,1,100
203,UnivariatePeriodicInterpolator,28,6,0,6,1,100
6,UnivariatePointValuePair,6,0,0,0,0,0
686,UnivariatePointValuePair,6,0,0,0,0,0
673,UnivariateSolverUtils,72,49,19,68,0.7205882,72.05882
157,UnknownParameterException,4,0,0,0,0,0
549,ValueServer,78,23,2,25,0.92,92
90,Variance,101,32,14,46,0.6956522,69.565216
18,Vector1D,71,15,1,16,0.9375,93.75
17,Vector1DFormat,19,3,1,4,0.75,75
620,Vector2D,54,16,18,34,0.47058824,47.058823
616,Vector2DFormat,18,3,1,4,0.75,75
497,Vector3D,142,46,0,46,1,100
489,Vector3DFormat,19,3,1,4,0.75,75
214,VectorFormat,37,15,1,16,0.9375,93.75
81,VectorialCovariance,39,19,9,28,0.6785714,67.85714
86,VectorialMean,20,12,4,16,0.75,75
538,Vertex,23,5,1,6,0.8333333,83.33333
387,WeibullDistribution,61,18,4,22,0.8181818,81.818184
424,Weight,4,0,2,2,0,0
679,Weight,4,0,2,2,0,0
216,WeightedObservedPoint,8,0,0,0,0,0
405,WeightedObservedPoint,8,0,0,0,0,0
412,WeightedObservedPoints,11,0,0,0,0,0
566,Well1024a,20,0,0,0,0,0
557,Well19937a,22,0,0,0,0,0
556,Well19937c,26,0,0,0,0,0
560,Well44497a,22,2,0,2,1,100
561,Well44497b,26,2,0,2,1,100
570,Well512a,17,0,0,0,0,0
647,WelzlEncloser,45,19,1,20,0.95,95
396,WilcoxonSignedRankTest,55,34,2,36,0.9444444,94.44444
483,WilsonScoreInterval,15,0,0,0,0,0
356,ZipfDistribution,57,24,0,24,1,100
