Sr.No,Class Name,Line Coverage,Branch Coverage,Branch Missed,Branch Missed+Covered,BranchCoveragePercentageDecimal,BranchCoveragePercentage
39,AbstractBagDecorator,8,4,0,4,1,100
126,AbstractBidiMapDecorator,5,0,0,0,0,0
51,AbstractBitwiseTrie,24,15,5,20,0.75,75
9,AbstractCollectionDecorator,23,2,0,2,1,100
117,AbstractDualBidiMap,64,18,0,18,1,100
228,AbstractEmptyIterator,12,0,0,0,0,0
138,AbstractHashedMap,269,125,11,136,0.9191176,91.911766
140,AbstractInputCheckedMapDecorator,7,2,0,2,1,100
8,AbstractIterableGetMapDecorator,18,2,2,4,0.5,50
157,AbstractIterableMap,2,0,0,0,0,0
206,AbstractIteratorDecorator,3,0,0,0,0,0
3,AbstractKeyValue,17,0,0,0,0,0
57,AbstractLinkedList,190,91,9,100,0.91,91
158,AbstractLinkedMap,72,40,0,40,1,100
59,AbstractListDecorator,16,4,0,4,1,100
197,AbstractListIteratorDecorator,17,1,1,2,0.5,50
168,AbstractListValuedMap,8,0,0,0,0,0
33,AbstractMapBag,163,74,8,82,0.902439,90.2439
153,AbstractMapDecorator,27,4,0,4,1,100
2,AbstractMapEntry,13,19,1,20,0.95,95
6,AbstractMapEntryDecorator,11,2,2,4,0.5,50
210,AbstractMapIteratorDecorator,0,0,2,2,0,0
255,AbstractMapMultiSet,101,43,5,48,0.8958333,89.58333
257,AbstractMultiSet,33,19,27,46,0.41304347,41.304348
252,AbstractMultiSetDecorator,6,4,0,4,1,100
167,AbstractMultiValuedMap,81,43,15,58,0.7413793,74.13793
171,AbstractMultiValuedMapDecorator,26,4,0,4,1,100
177,AbstractNavigableSetDecorator,7,0,0,0,0,0
121,AbstractOrderedBidiMapDecorator,7,0,0,0,0,0
132,AbstractOrderedMapDecorator,9,0,0,0,0,0
211,AbstractOrderedMapIteratorDecorator,0,0,2,2,0,0
50,AbstractPatriciaTrie,306,196,100,296,0.6621622,66.21622
81,AbstractQuantifierPredicate,3,0,0,0,0,0
260,AbstractQueueDecorator,4,0,0,0,0,0
135,AbstractReferenceMap,106,39,9,48,0.8125,81.25
54,AbstractSerializableListDecorator,8,0,0,0,0,0
179,AbstractSerializableSetDecorator,8,0,0,0,0,0
176,AbstractSetDecorator,5,4,0,4,1,100
170,AbstractSetValuedMap,8,0,0,0,0,0
37,AbstractSortedBagDecorator,5,0,0,0,0,0
119,AbstractSortedBidiMapDecorator,3,0,0,0,0,0
161,AbstractSortedMapDecorator,8,0,4,4,0,0
184,AbstractSortedSetDecorator,6,0,0,0,0,0
199,AbstractUntypedIteratorDecorator,8,1,1,2,0.5,50
111,AllPredicate,18,12,0,12,1,100
110,AndPredicate,8,7,1,8,0.875,87.5
82,AnyPredicate,17,11,1,12,0.9166667,91.66667
227,ArrayIterator,28,10,0,10,1,100
201,ArrayListIterator,25,8,0,8,1,100
164,ArrayListValuedHashMap,16,0,2,2,0,0
245,ArrayStack,24,10,6,16,0.625,62.5
239,ArrayUtils,9,9,7,16,0.5625,56.25
233,BagUtils,11,0,0,0,0,0
19,BooleanComparator,17,13,1,14,0.9285714,92.85714
214,BoundedIterator,31,17,1,18,0.9444444,94.44444
156,CaseInsensitiveMap,19,4,0,4,1,100
85,CatchAndRethrowClosure,8,0,0,0,0,0
98,ChainedClosure,23,12,0,12,1,100
77,ChainedTransformer,19,10,0,10,1,100
262,CircularFifoQueue,86,44,4,48,0.9166667,91.66667
96,CloneTransformer,7,2,0,2,1,100
100,ClosureTransformer,8,2,0,2,1,100
238,ClosureUtils,28,4,0,4,1,100
220,CollatingIterator,87,39,9,48,0.8125,81.25
44,CollectionBag,42,21,3,24,0.875,87.5
45,CollectionSortedBag,42,21,3,24,0.875,87.5
241,CollectionUtils,337,250,20,270,0.9259259,92.59259
20,ComparableComparator,8,6,0,6,1,100
23,ComparatorChain,58,27,15,42,0.64285713,64.28571
65,ComparatorPredicate,23,17,3,20,0.85,85
235,ComparatorUtils,25,14,4,18,0.7777778,77.77778
14,CompositeCollection,83,41,1,42,0.97619045,97.61904
137,CompositeMap,86,47,3,50,0.94,94
181,CompositeSet,109,59,5,64,0.921875,92.1875
99,ConstantFactory,8,2,0,2,1,100
91,ConstantTransformer,11,3,11,14,0.21428572,21.428572
61,CursorableLinkedList,77,20,6,26,0.7692308,76.92308
152,DefaultedMap,21,7,3,10,0.7,70
97,DefaultEquator,6,6,2,8,0.75,75
5,DefaultKeyValue,24,19,5,24,0.7916667,79.16667
26,DeleteCommand,4,0,0,0,0,0
124,DualHashBidiMap,14,0,0,0,0,0
120,DualLinkedHashBidiMap,14,0,0,0,0,0
123,DualTreeBidiMap,51,10,2,12,0.8333333,83.33333
29,EditCommand,4,0,0,0,0,0
31,EditScript,19,2,0,2,1,100
198,EmptyIterator,6,0,0,0,0,0
218,EmptyListIterator,5,0,0,0,0,0
190,EmptyMapIterator,4,0,0,0,0,0
226,EmptyOrderedIterator,4,0,0,0,0,0
204,EmptyOrderedMapIterator,4,0,0,0,0,0
225,EntrySetMapIterator,0,0,10,10,0,0
142,EntrySetToMapIteratorAdapter,18,2,0,2,1,100
188,EnumerationIterator,10,0,4,4,0,0
232,EnumerationUtils,13,6,0,6,1,100
89,EqualPredicate,15,6,0,6,1,100
107,ExceptionClosure,6,0,0,0,0,0
87,ExceptionFactory,6,0,0,0,0,0
67,ExceptionPredicate,6,0,0,0,0,0
113,ExceptionTransformer,6,0,0,0,0,0
71,FactoryTransformer,7,2,0,2,1,100
246,FactoryUtils,6,0,0,0,0,0
101,FalsePredicate,6,0,0,0,0,0
193,FilterIterator,32,13,1,14,0.9285714,92.85714
219,FilterListIterator,58,30,6,36,0.8333333,83.33333
21,FixedOrderComparator,57,44,22,66,0.6666667,66.66667
56,FixedSizeList,16,0,0,0,0,0
131,FixedSizeMap,20,2,4,6,0.33333334,33.333336
148,FixedSizeSortedMap,21,2,2,4,0.5,50
149,Flat3Map,328,226,64,290,0.77931035,77.93104
236,FluentIterable,45,4,0,4,1,100
73,ForClosure,12,8,0,8,1,100
104,FunctorUtils,36,27,3,30,0.9,90
60,GrowthList,20,5,1,6,0.8333333,83.33333
47,HashBag,11,0,0,0,0,0
144,HashedMap,15,0,0,0,0,0
253,HashMultiSet,12,0,0,0,0,0
166,HashSetValuedHashMap,13,0,0,0,0,0
83,IdentityPredicate,7,4,0,4,1,100
108,IfClosure,13,5,3,8,0.625,62.5
84,IfTransformer,17,10,2,12,0.8333333,83.33333
11,IndexedCollection,55,21,1,22,0.95454544,95.454544
30,InsertCommand,4,0,0,0,0,0
80,InstanceofPredicate,6,1,1,2,0.5,50
92,InstantiateFactory,27,17,5,22,0.77272725,77.27273
68,InstantiateTransformer,19,14,10,24,0.5833333,58.333332
103,InvokerTransformer,28,24,4,28,0.85714287,85.71429
244,IterableUtils,120,59,3,62,0.9516129,95.161285
189,IteratorChain,43,14,6,20,0.7,70
224,IteratorEnumeration,6,0,0,0,0,0
195,IteratorIterable,12,5,1,6,0.8333333,83.33333
237,IteratorUtils,168,100,42,142,0.70422536,70.42254
25,KeepCommand,4,0,0,0,0,0
48,KeyAnalyzer,7,6,8,14,0.42857143,42.857143
209,LazyIteratorChain,28,12,0,12,1,100
64,LazyList,15,6,2,8,0.75,75
129,LazyMap,24,6,0,6,1,100
141,LazySortedMap,16,0,0,0,0,0
150,LinkedMap,21,4,0,4,1,100
229,ListIteratorWrapper,61,32,8,40,0.8,80
147,ListOrderedMap,99,38,4,42,0.9047619,90.47619
182,ListOrderedSet,78,33,3,36,0.9166667,91.66667
248,ListUtils,90,66,8,74,0.8918919,89.189186
203,LoopingIterator,17,8,0,8,1,100
213,LoopingListIterator,39,21,3,24,0.875,87.5
145,LRUMap,87,31,9,40,0.775,77.5
174,MapBackedSet,31,9,1,10,0.9,90
66,MapTransformer,7,2,0,2,1,100
247,MapUtils,285,178,10,188,0.9468085,94.680855
4,MultiKey,37,12,0,12,1,100
146,MultiKeyMap,304,191,109,300,0.63666666,63.666664
242,MultiMapUtils,22,16,4,20,0.8,80
250,MultiSetUtils,6,0,0,0,0,0
162,MultiValueMap,86,39,5,44,0.8863636,88.63636
52,NodeCachingLinkedList,51,12,0,12,1,100
205,NodeListIterator,15,9,3,12,0.75,75
72,NonePredicate,14,8,0,8,1,100
116,NOPClosure,6,0,0,0,0,0
95,NOPTransformer,6,0,0,0,0,0
70,NotNullPredicate,6,2,0,2,1,100
114,NotPredicate,7,4,0,4,1,100
22,NullComparator,17,16,8,24,0.6666667,66.66667
90,NullIsExceptionPredicate,9,4,0,4,1,100
93,NullIsFalsePredicate,9,4,0,4,1,100
102,NullIsTruePredicate,9,4,0,4,1,100
79,NullPredicate,6,2,0,2,1,100
192,ObjectArrayIterator,27,12,0,12,1,100
230,ObjectArrayListIterator,23,8,0,8,1,100
207,ObjectGraphIterator,56,30,0,30,1,100
109,OnePredicate,16,9,1,10,0.9,90
69,OrPredicate,8,7,1,8,0.875,87.5
143,PassiveExpiringMap,66,18,0,18,1,100
215,PeekingIterator,35,21,3,24,0.875,87.5
222,PermutationIterator,45,34,0,34,1,100
34,PredicatedBag,11,4,0,4,1,100
13,PredicatedCollection,20,8,0,8,1,100
63,PredicatedList,21,6,0,6,1,100
134,PredicatedMap,32,16,0,16,1,100
256,PredicatedMultiSet,11,4,0,4,1,100
185,PredicatedNavigableSet,15,0,0,0,0,0
263,PredicatedQueue,10,0,0,0,0,0
180,PredicatedSet,6,4,0,4,1,100
36,PredicatedSortedBag,7,0,0,0,0,0
133,PredicatedSortedMap,13,0,0,0,0,0
186,PredicatedSortedSet,13,0,0,0,0,0
86,PredicateTransformer,7,2,0,2,1,100
231,PredicateUtils,26,0,0,0,0,0
94,PrototypeFactory,13,4,0,4,1,100
223,PushbackIterator,12,5,3,8,0.625,62.5
249,QueueUtils,6,0,0,0,0,0
160,ReferenceIdentityMap,16,6,0,6,1,100
151,ReferenceMap,10,0,0,0,0,0
28,ReplacementsFinder,0,0,4,4,0,0
18,ReverseComparator,12,6,2,8,0.75,75
196,ReverseListIterator,31,6,2,8,0.75,75
27,SequencesComparator,79,79,3,82,0.9634146,96.34146
62,SetUniqueList,69,26,2,28,0.9285714,92.85714
234,SetUtils,36,31,1,32,0.96875,96.875
191,SingletonIterator,22,14,0,14,1,100
216,SingletonListIterator,32,26,2,28,0.9285714,92.85714
155,SingletonMap,50,15,20,35,0.42857143,42.857143
194,SkippingIterator,17,8,0,8,1,100
24,SortedProperties,8,2,0,2,1,100
240,SplitMapUtils,8,7,3,10,0.7,70
154,StaticBucketMap,121,63,11,74,0.8513514,85.13514
32,StringKeyAnalyzer,36,24,10,34,0.7058824,70.588234
74,StringValueTransformer,6,0,0,0,0,0
106,SwitchClosure,35,22,2,24,0.9166667,91.66667
88,SwitchTransformer,36,24,2,26,0.9230769,92.30769
35,SynchronizedBag,19,2,0,2,1,100
15,SynchronizedCollection,55,9,3,12,0.75,75
254,SynchronizedMultiSet,19,2,0,2,1,100
259,SynchronizedQueue,22,2,0,2,1,100
40,SynchronizedSortedBag,3,0,0,0,0,0
1,TiedMapEntry,21,17,5,22,0.77272725,77.27273
42,TransformedBag,18,7,1,8,0.875,87.5
10,TransformedCollection,21,7,1,8,0.875,87.5
55,TransformedList,26,7,1,8,0.875,87.5
139,TransformedMap,38,10,2,12,0.8333333,83.33333
165,TransformedMultiValuedMap,35,16,4,20,0.8,80
187,TransformedNavigableSet,15,0,4,4,0,0
105,TransformedPredicate,10,3,1,4,0.75,75
261,TransformedQueue,16,3,1,4,0.75,75
175,TransformedSet,12,7,1,8,0.875,87.5
41,TransformedSortedBag,6,0,4,4,0,0
130,TransformedSortedMap,19,1,1,2,0.5,50
183,TransformedSortedSet,12,0,4,4,0,0
7,TransformedSplitMap,23,5,3,8,0.625,62.5
78,TransformerClosure,8,2,0,2,1,100
115,TransformerPredicate,10,4,0,4,1,100
251,TransformerUtils,34,4,0,4,1,100
17,TransformingComparator,22,13,9,22,0.59090906,59.090908
200,TransformIterator,9,0,0,0,0,0
43,TreeBag,21,6,0,6,1,100
118,TreeBidiMap,433,226,29,255,0.8862745,88.62745
53,TreeList,53,16,2,18,0.8888889,88.88889
243,TrieUtils,1,0,0,0,0,0
112,TruePredicate,6,0,0,0,0,0
76,UniquePredicate,5,0,0,0,0,0
46,UnmodifiableBag,20,2,0,2,1,100
122,UnmodifiableBidiMap,23,4,0,4,1,100
12,UnmodifiableBoundedCollection,21,9,5,14,0.64285713,64.28571
16,UnmodifiableCollection,13,2,0,2,1,100
128,UnmodifiableEntrySet,27,10,2,12,0.8333333,83.33333
208,UnmodifiableIterator,12,4,0,4,1,100
58,UnmodifiableList,21,2,0,2,1,100
212,UnmodifiableListIterator,18,4,0,4,1,100
136,UnmodifiableMap,22,2,2,4,0.5,50
217,UnmodifiableMapIterator,15,4,0,4,1,100
258,UnmodifiableMultiSet,21,2,0,2,1,100
169,UnmodifiableMultiValuedMap,13,2,0,2,1,100
178,UnmodifiableNavigableSet,32,2,0,2,1,100
125,UnmodifiableOrderedBidiMap,24,4,0,4,1,100
163,UnmodifiableOrderedMap,24,2,0,2,1,100
202,UnmodifiableOrderedMapIterator,17,4,0,4,1,100
264,UnmodifiableQueue,20,2,0,2,1,100
172,UnmodifiableSet,13,2,0,2,1,100
38,UnmodifiableSortedBag,19,2,0,2,1,100
127,UnmodifiableSortedBidiMap,29,4,0,4,1,100
159,UnmodifiableSortedMap,21,2,0,2,1,100
173,UnmodifiableSortedSet,24,2,0,2,1,100
49,UnmodifiableTrie,30,4,0,4,1,100
75,WhileClosure,15,8,0,8,1,100
221,ZippingIterator,34,13,1,14,0.9285714,92.85714
